#,#,#,#,#,#,#,#
#,X,#, , , , ,#
#, ,#, ,#,#, ,#
#, , , ,#,#, ,#
#, ,#,#, , , ,#
#, ,#,#, ,#,#,#
#, , ,#, , , ,
#,#,#,#,#,#,#,#