#,#,#,#,#,#,#,#,#,#,#,#
#,X, , , , , , , , , ,#
#, ,#,#,#,#,#,#, ,#,#,#
#, ,#, , , , , , , , ,#
#, ,#, ,#,#,#,#,#,#, ,#
#, ,#, ,#, , , , , , ,#
#, , , ,#,#, ,#,#,#, ,#
#, ,#, , , , ,#, ,#,#,#
#, ,#,#, ,#, , , , , ,#
#, ,#, , ,#,#,#,#,#, ,#
#, , , ,#,#, , , , , ,#
#,#,#,#,#,#,#,#,#,#, ,#